u v e f w w r w v f e u r
x w w w w w t w w w b x w
j g g s g g g s g g c j g
g g g g s g g z g g g g n
s g a s g g g g g s g p a
g g g g a g m g g g p g z
g g g g g g p a g g g g g
g g s g z g g s g g g z g
z g n g g g g g g g m g g
z z a g g g g g g g g g z