u f f f w e e w f f f u w
x w w w w w t w w w b x w
j g g s g g g s g g c j g
g g g g g g g g g g g g g
g g g g g g g g g g g g g
g g g g g g g g g g g g g
g g g g g g g g g g g g g
g g g g g g g g g g g g g
g g g g g g g g g g g g g
g g g g g g g g g g g g g